NO ./assets/floor1.xpm
SO ./assets/floor1.xpm
WE 		 ./assets/floor1.xpm
EA ./assets/floor1.xpm

F    135,139,34
C 255,228,181

11111111111111111111111111111111111111111111111111111111111111111111111111111111111111111
10000000111111111100000000000011111111000000000000000000000000000011111111111111111000001
10000000000000000000000000000000000000000000000000000000000000000000000000000000000000001
10000000000000000000000000000000000000000000000000000000000000000000000000000000000000001
10000000000000000000000000000000000000000000000000000000000000000000000000000000000000001
100000000000000000000000000000000000000000E0000000001111111111111111111111100000000000001
10000000000000000000000000000000000000000000000000000000000000000000000000000000000000001
10000000000000000000000000000000000000000000000000000000000000000000000000000000000000001
10000000000111111111111111111110000000000000000000000000000000000000000000000000000000001
10000000000000000000000000000000000000000000000000000000000000000000000000000000000000001
10000000000000000000000000000000000000000000000000000000000000000000000000000000000000001
10000000000000000000000000000000000000000000000000000000111111110000000000000000000000001
10000000000000000000001100000000000000000000000000000000000000000000000000000000000000001
10000000000000000000000000000000000000000000000000000000000000000000000000000000000000001
10000000000000000000000000000000000000000000000000000000000000000000000000000000000000001
10000000000000000000000000000000000111111111100000000000000000000000000000000000000000001
10000000000000000000000000000000000000000000000000000000000000000000000000000000000000001
10000000000000000000000000000000000000000000000000000000000000000000000000000000000000001
10000000000000000000000000000000000000000000000000000000000000000000000000000000000000001
10000000000000111111111111110000000000000111111111111111111100000000000000000000000000001
10000000000000000000000000000000000000000000000000000000000000000000000000000000000000001
10000000000000000000000000000000000000000000000000000000000000000000000000000000000000001
11111111111111111111111111111111111111111111111111111111111111111111111111111111111111111
