NO ./assets/floor1.xpm
SO ./assets/floor1.xpm
WE 		 ./assets/floor1.xpm
EA ./assets/floor1.xpm

F    135,139,34
C 255,228,181

1111
10N 
1111
