NO ./assets/floor1.xpm
SO ./assets/floor1.xpm
WE ./assets/floor1.xpm
EA ./assets/floor1.xpm

F 220,100,14
C 225,30,185

11111111111111111111111111111
10000000000011000000000000001
10000011110011000001111100001
100001    1100000000000100001
100001     100000000000100001
1000001   1111100000000100001
10000001110000100000000100001
10000000000000100000000100001
10000001100000010000000100101
10000000000000100000000100001
10001000100110000010000100001
10000000000000000000000100001
10000000000000000000000100001
10000000000000000000000100001
100000100000000000000100000E1
11111111111111111111111111111