NO ./assets/stone_bricks.xpm
SO ./assets/stone_bricks2.xpm
WE ./assets/stone_bricks3.xpm
EA ./assets/stone_bricks4.xpm

F 112,223,255
C 140,160,100

11111111111111111111111111111
10000000000011000000000000001
10000011110011000001111100001
100001    11000S0000000100001
100001     100000000000100001
1000001   1111100000000100001
10000001110000100000000100001
10000000000000100000000100001
10000001100000010000000100101
10000000000000100000000100001
10001000100110000010000100001
10000000000000000000000100001
10000000000000000000000100001
10000000000000000000000100001
10000010000000000000010000001
11111111111111111111111111111