NO ./assets/stone_bricks.xpm
SO ./assets/stone_bricks2.xpm
WE ./assets/stone_bricks3.xpm
EA ./assets/stone_bricks4.xpm

F 112,223,255
C 140,160,100

        1111111111111111111111111
        1000000000110000000000001
        1011000001110000000000001
        1001000000000000000000001
111111111011000001110000000000001
100000000011000001110111110111111
11110111101111011100000010001
11110111100001011101010010001
11000000110101011100000010001
100000000000000000000000000W1
10000000000000001101010010001
1100000111010101111101111000111
11000111 1000101 101111010001
11111111 1111111 111111111111