NO ./assets/floor1.xpm
SO ./assets/floor1.xpm
WE 		 ./assets/floor1.xpm
EA ./assets/floor1.xpm

F    135,139,34
C 255,228,181

111111111111
100000001101
101011110001
10N010001001
111011110011
100000001111
111011110011
100000001111
111011110011
100000001111
111111111111