NO ./assets/floor1.xpm
SO ./assets/floor1.xpm
WE 		 ./assets/floor1.xpm
EA ./assets/floor1.xpm

F    135,139,34
C 255,228,181

11111111111111
10000000111101
10101111000001
10001000011001
11101111000011
100000N0001111
11101111000011
10000000001111
11101111000011
10000000001111
11111111111111
