NO ./assets/floor1.xpm
SO ./assets/floor1.xpm
WE ./assets/floor1.xpm
EA ./assets/floor1.xpm

F 34,139,34
C 255,228,181

111111111
1E0000001
1010111001
1000100001
1110101111
1000000001
111111111
