NO ./assets/stone_bricks.xpm
SO ./assets/stone_bricks2.xpm
WE 		./assets/stone_bricks3.xpm
EA ./assets/stone_bricks4.xpm

F 112,223,255
C     140,160,100  
111111111
1E0000001
10101110011
1000100001
1110101111
1000000001
111111111
